111111111111111111111111111111111
100000000000000000000000000000001
11011111CCCCCCCCCCCC0CCC111100011
111111CCCCCCCCCCCCC0C0CCC11000011
110000000000000000000000000001E11
100000000000000000000P00000000001
111111111111111111111111111111111