11111111111111111111111111111111
11110010101111111111111111011111
1111111P0000000000000000000EC111
111100000000000C00000C0000000111
11111000000010000000000000111111
1111111000C0000000100C0000000111
1110000000000000000000C011111001
11111111111111111111111111111111