111111111111111111111
111111111110000000001
111111100000000100101
100000000000000000001
111111111111111111111