1111111111111111
1E00P00000C00011
1111111111111111




11111111111
1C0+XXXXX11
111XXXX1111
11111111111