1111111111111111
1E00P00000C00011
1111111111111111