11111111111111111111111111111111
11110010101111111111111111011111
1111111P000000000000000000MEC111
111100000000000C00000C0000000111
1111100000001000000M000000111111
1111111000C0000000100C0000000111
111000000000000M000000C011111001
11111111111111111111111111111111