11111111111111111111111111111
11P00000000000000000011111111
111111110000E0000MC0001111111
11111111111111111111111111111
11111111111111111111111111111
11111111111111111111111111111