11111111111111111111111111111111
1111001C001111111111111111000111
1111111P0000000000000000000E0111
1111C0000000M0000000000000000111
11111000000010000000000000111111
1111111000M0000M00MM00M000000111
11100000000000000000000011111011
11111111111111111111111111111111