11111111111111111111111111111111
1111001C001111111111111111111111
1111111P00000000000C0000000E1111
1111C0000000M0000000C11111111111
11111111111110000000000000111111
1111111C00MM000M00MM00M000000111
11100000000000000000000011111011
11111111111111111111111111111111