1111111111111111111
1P0EC00000M00000011
1111111111111111111