11111111111111111111111111111111
11111111111111111111111111111111
1111111P1111111111111111111E1111
11111111111111111111111111111111
11111111111110000000000000111111
1111111C111111111111111111111111
11111111111111111111111111111011
11111111111111111111111111111111