1111111111111111111
1P0C0M00000000000E1
1000000000000000001
1111111111111111111