111111111111111111111111111111111
100000000000000000000000000000001
11011111CCCC1CCCCCCC0CCC111100011
111111CCCCC1C0CCCCC0C0CCC11000011
110000000000100000000000000001E11
10000000000000000P000000000000001
111111111111111111111111111111111